NO ./textures/north.xpm
SO ./textures/south.xpm
WE ./textures/west.xpm
EA ./textures/east.xpm
F 220,100,0
C 225,30,0

11111111111111111111111111111
10000000000000000000000000001
10000000000W00000000000000001
10000000000000000000000000001
10011111110011111100011100001
10010000010010000100000100001
10010000010010000100000100001
10011111110011111100000100001
10000000010010000000000100001
10000000010010000000000100001
10011111110010000000000100001
10000000000000000011111100001
10000000000000000000000000001
10011111111111110000000000001
10000000000000010000000000001
10000000000000010000000000001
10000000000000010000000000001
10000000000000010000000000001
10011111111111110000000000001
10000000000000000000000000001
10000000000000000000000000001
10000011111111111111000000001
10000010000000000001000000001
10000010000000000001000000001
10000010000000000001000000001
10000011111100011111000000001
10000000000100010000000000001
10000000000100010000000000001
10000000000100010000000000001
10000011111111111111000000001
10000000000000000000000000001
11111111111111111111111111111